C 15,23 ,11
F 42,055,15
EA ./assets/textures/wall_1.xpm
NO ./assets/textures/wall_2.xpm
SO ./assets/textures/wall_3.xpm 
WE ./assets/textures/wall_4.xpm 

11111111111111
11S10101010101
10101010101011
11010101010101
10101010101011
11010101010101
10101010101011
11111111111111