C 10,231 ,227
F 42,055,15
EA ./assets/textures/wall_1.xpm
NO ./assets/wall_2.xpm
SO ./assets/wall_3.xpm 
WE ./assets/wall_4.xpm 

1111
1001
1011
100011
100000111111
100000000001111111111111
100000000000000000110001
100000000000000000110N01
100000000000000000110001
100000000000000000110001
111111111111101111110001
111111111111100000000001
111111111111111111111111