C 15,23 ,11
F 42,055,15
EA ./assets/textures/wall_1.xpm
NO ./assets/textures/wood.xpm
SO ./assets/textures/wall_3.xpm 
WE ./assets/textures/wall_4.xpm 
  1  
1101
10N1
1011
100011
100000111111
100000000001111111111111
100000000000000000110001
100000000000000000110001
100000000000000000110001
100000000000000000110001
111111100011101111110001
111111100011100000000001
111111100011111111111111
100000000000000000110001
100000000000000000110001
100000000000000000110001
100000000000000000110001
111111100011101111110001
111111100011100000000001
111111100011111111111111
100000000000000000110001
100000000000000000110001
100000000000000000110001
100000000000000000110001
111111100011101111110001
111111100011100000000001
111111100011111111111111
100000000000000000110001
100000000000000000110001
100000000000000000110001
100000000000000000110001
1111111000111011110000011
11111100011100000000000001
1111111111111111111111111