C		  42, 			231 ,227
F	123,55,42
EA ./assets/textures/wall_1.xpm      
   NO     ./assets/wall_2.xpm
         SO     ./assets/wall_3.xpm
   WE     ./assets/wall_4.xpm 

111
10111
101S1
11111