C 15,23 ,11
F 42,055,15
EA ./assets/textures/wall_1.xpm
NO ./assets/textures/wall_2.xpm
SO ./assets/textures/wall_3.xpm
WE ./assets/textures/wall_4.xpm
  1  
1101
1001
1011
100011
100000111111
10000000N001111111111111
100011100011100000000011
10001 10001 100000110001
10001 10001 100000110001
10001 10001 100000110001
100011100011100000000011
111111100011101111110001
111111100011100000000001
1111111000111111111110111111111111111
100000000000000000110001          101
100000000000000000110001          101
100000000000000000000001          101
100000000000000000110001          101
111111100011101111110001         1001
111111100011100000000001        10001
111111100011111111111011        10001
1000000000000000001100011111111110001
1000000000000000001100000000000000001
1000000000000000001100011111111111111
100000000000000000110001
111111100011101111110001
111111100011100000000001
111111100011111111111111
100000000000000000110001
100000000000000000110001
100000000000000000110001
100000000000000000110001
1111111000111011110000011
11111100011100000000000001
1111111111111111111111111
